WPPWWWWWW
WWPWPSWWW
WWPWPWWWW
PPPPPWWWW
PWPWPPPFW
WPPPPWWWW