WWWWWWWWWWWWWWWWWWWWWWWW
WWWWWWWPPPPWWWWWWWWWWWWW
WWWWPPPPWWPWWWWWWWWWWWWW
WWWWPWWWWWPWWWWWWPPPPPPS
WWWWPWWWWWPWWWWWWPWWWWWW
WWWWPWWWWWPPPWWWPPWWWWWW
WWWWPWWWWWPPPWWWPWWWWWWW
FPPPPWWWWWPPPPPPPWWWWWWW
WWWWWWWWWWWWWWWWWWWWWWWW
WWWWWWWWWWWWWWWWWWWWWWWW
WWWWWWWWWWWWWWWWWWWWWWWW
WWWWWWWWWWWWWWWWWWWWWWWW