WWPPWSWWWWWWPPPP
WWWPPPPPPPPPWPWW
WWWPWWWWPWWPWPPP
WWWPWWWPWWWPWPWP
WWWPPPPPWWWPPPWW
WWWPWWWWWWWWWWWW
WPPPPPPPPPPPPPPF