WWWWWWWWWWWWWWWWWWWWWWWW
WWWWWWWPPPPWWWWWWWWWWWWW
WWWWPPPPWWPWWWWWWWWWWWWW
WWWWPWWWWWPWWWWWWPPPPPPS
WWWWPWWWWWPWWWWWWPWWWWWW
WWWWPWWWWWPPPWWWPPWWWWWW
WWWWPWWWWWPPPWWWPWWWWWWW
FPPPPWWWWWWWPPPPPWWWWWWW
WWWWWWWWWWWWWWWWWWWWWWWW
WWWWWWWWWWWWWWWWWWWWWWWW
WWWWWWWWWWWWWWWWWWWWWWWW
WWWWWWWWWWWWWWWWWWWWWWWW