WWPPWSWWWWWWPPPP
WWWPPPPPPPPPWPWW
WWWPWWWWPWWPWPPP
WWWHWWWPWWWPWPWP
WWWPPPPPWWWPPPWW
WWWPWWWWWWWWWWWW
WPPPPPPPHPPPPPPF