WPPWWWWWW
WWPWPSWWW
WWPWPWWWW
PPPPHWWWW
PWPWPPPFW
WPHPPWWWW