WPPWWWWW
WWPWPSWW
WWPWPWWW
PPPPHWFW
WWPWWPPW
PPHPPPWW
WWWWWWWW