WWWWWWWWWWWWWWWWWWWWWWWW
WWWWWWWPHPPWWWWWWWWWWWWW
WWWWPPPPWWPWWWWWWWWWWWWW
WWWWPWWWWWPWWWWWWPPPPPPS
WWWWPWWWWWPWWWWWWHWWWWWW
WWWWHWWWWWPPHWWWPPWWWWWW
WWWWPWWWWWPPPWWWPWWWWWWW
FPPPPWWWWWPPPPPPPWWWWWWW
WWWWWWWWWWWWWWWWWWWWWWWW
WWWWWWWWWWWWWWWWWWWWWWWW
WWWWWWWWWWWWWWWWWWWWWWWW
WWWWWWWWWWWWWWWWWWWWWWWW