WPPWWWWW
WWPWPSWW
WWPWPWWW
PPPPPWFW
WWPWWPPW
PPPPPPWW
WWWWWWWW